OBJECTID1,HUC_10,HU_10_NAME,DWQ_Basin,Area_sqmi,TOTAL_POP,POP_2010,POP_2000,POP_CHG_10_20,POP_CHG_00_10,ACRES,Latitude,Longtidude
361,303000502,Turnbull Creek-Cape Fear River,Cape Fear,193,9048,10509,9599,-1461,910,123424.3249,34.7256634,-78.4904278
362,303000405,Buies Creek-Cape Fear River,Cape Fear,167,54120,45463,36115,8657,9348,106726.9292,35.4280151,-78.7391167
363,303000401,Buckhorn Creek-Cape Fear River,Cape Fear,231,38168,26115,18148,12053,7967,147657.592,34.7256634,-78.4904278
364,303000402,Upper Little River,Cape Fear,220,42785,37465,30431,5320,7034,141050.0006,34.8002309,-78.4824501
365,303000508,Cape Fear River,Cape Fear,79,19627,13860,9452,5767,4408,50593.11004,34.7256634,-78.4904278
366,303000302,Upper Deep River,Cape Fear,294,34843,34924,32765,-81,2159,188420.7343,41.3648171,-72.4849861
367,303000306,Lower Deep River,Cape Fear,226,37062,35488,30191,1574,5297,144671.3361,41.3648171,-72.4849861
368,303000304,Middle Deep River,Cape Fear,302,17585,19001,18472,-1416,529,193322.5942,41.3648171,-72.4849861
369,303000503,Livingston Creek,Cape Fear,101,3554,3968,3544,-414,424,64612.96818,34.3158801,-78.2621753
370,303000403,Headwaters Little River,Cape Fear,262,49525,39558,33583,9967,5975,167364.4257,34.3158801,-78.2621753
371,303000501,Harrison Creek-Cape Fear River,Cape Fear,163,15586,13995,11494,1591,2501,104552.7927,34.7256634,-78.4904278
372,303000303,Mclendons Creek,Cape Fear,101,6132,6309,5919,-177,390,64751.90251,35.416722,-79.4253769
373,303000301,Headwaters Deep River,Cape Fear,283,193894,180870,158400,13024,22470,181107.4273,36.0048676,-79.976619
374,303000305,Rocky River,Cape Fear,243,22660,22996,20627,-336,2369,155805.6106,41.4768217,-81.8497567
375,303000505,Brunswick River-Cape Fear River,Cape Fear,95,64968,51537,37362,13431,14175,60881.43929,34.2178671,-77.9767183
376,303000601,Upper South River,Cape Fear,234,39924,41286,37477,-1362,3809,149771.0891,45.466667,-61.933333
377,303000507,Liliput Creek-Cape Fear River,Cape Fear,89,34437,29672,17809,4765,11863,57112.9113,34.7256634,-78.4904278
378,303000506,Town Creek,Cape Fear,126,7116,6429,4878,687,1551,80407.47935,34.6812011,-87.4061342
379,303000504,Hood Creek-Cape Fear River,Cape Fear,215,10346,8761,7582,1585,1179,137762.3002,34.284403,-78.1395305
380,303000404,Outlet Little River,Cape Fear,220,67274,55075,50439,12199,4636,140533.9962,33.8732279,-78.6141798
381,303000406,Rockfish Creek,Cape Fear,309,217796,204010,173271,13786,30739,198044.2964,34.9602329,-78.8612554
382,303000407,Cross Creek-Cape Fear River,Cape Fear,222,106862,103103,103577,3759,-474,141802.6823,34.7256634,-78.4904278
383,303000708,Harrisons Creek-Northeast Cape Fear River,Cape Fear,287,93226,86208,69918,7018,16290,183910.885,34.7279398,-77.8765814
384,303000703,Limestone Creek-Northeast Cape Fear River,Cape Fear,257,15605,17655,15074,-2050,2581,164633.463,35.7595731,-79.0192997
385,303000607,Moores Creek,Cape Fear,92,3112,3457,3045,-345,412,58906.185,34.4581512,-78.1104428
386,304010107,Fisher River,Yadkin Pee Dee,161,15682,16559,14886,-877,1673,103057.9301,36.403628,-80.7684709
387,304010106,Elkin Creek-Yadkin River,Yadkin Pee Dee,136,18439,18962,18478,-523,484,86994.41132,36.3263208,-80.9152279
388,303000706,Angola Swamp-Northeast Cape Fear River,Cape Fear,377,5565,5762,5245,-197,517,241486.0085,34.7058938,-77.8710285
389,304010104,Roaring River-Yadkin River,Yadkin Pee Dee,184,11579,12481,12431,-902,50,117715.4155,36.060108,-81.5650931
390,303000608,Black River,Cape Fear,212,3444,4121,3998,-677,123,135860.0239,34.331868,-78.0325363
391,304010108,Upper Ararat River,Yadkin Pee Dee,76,25572,26149,26937,-577,-788,48339.03023,36.4682019,-80.5437971
392,303000606,Colly Creek,Cape Fear,122,1134,1224,1060,-90,164,77825.98716,-31.6212954,150.7812253
393,303000704,Cypress Creek-Northeast Cape Fear River,Cape Fear,154,11188,11492,8848,-304,2644,98365.61683,34.7256634,-78.4904278
394,303000604,Great Coharie Creek,Cape Fear,221,21677,23087,21772,-1410,1315,141497.3508,34.7896148,-78.3124988
395,303000701,Goshen Swamp,Cape Fear,185,8024,10555,8253,-2531,2302,118640.7007,35.0423509,-77.8953067
396,304010105,Mitchell River,Yadkin Pee Dee,108,6100,6171,5932,-71,239,69231.23548,36.35992,-80.8377466
397,303000602,Lower South River,Cape Fear,260,9766,10293,9595,-527,698,166402.1452,45.601171,-61.91325
398,304010102,W Kerr Scott Reservoir-Yadkin River,Yadkin Pee Dee,189,8620,9257,8293,-637,964,120849.9984,36.060108,-81.5650931
399,303000603,Little Coharie Creek,Cape Fear,159,9853,10324,9805,-471,519,101582.6096,35.0213469,-78.4865444
400,304010103,Reddies River-Yadkin River,Yadkin Pee Dee,211,34985,36338,34139,-1353,2199,134935.4745,36.1600571,-81.1554539
401,304010101,Headwaters Yadkin River,Yadkin Pee Dee,176,6571,6817,6852,-246,-35,112701.4468,36.060108,-81.5650931
402,303000605,Six Runs Creek,Cape Fear,274,16135,17896,17606,-1761,290,175512.4471,35.0194103,-78.2362169
403,303000707,Long Creek,Cape Fear,141,6299,6460,5854,-161,606,89921.51255,34.4421115,-78.0097139
404,303000702,Headwaters Northeast Cape Fear River,Cape Fear,162,12470,15349,11957,-2879,3392,103585.8491,34.7279398,-77.8765814
405,303000705,Rockfish Creek,Cape Fear,178,10958,12679,11377,-1721,1302,114006.6021,34.9602329,-78.8612554
406,304010111,Deep Creek,Yadkin Pee Dee,125,15655,16219,15322,-564,897,79764.14127,39.5116824,-79.3155716
407,304010403,Eury Dam-Little River,Yadkin Pee Dee,228,18517,19613,18714,-1096,899,146130.95,35.2538111,-79.9089306
408,304010202,Hunting Creek,Yadkin Pee Dee,206,11133,11583,10996,-450,587,131541.7873,38.2382507,-76.4604263
409,304010114,Dutchmans Creek,Yadkin Pee Dee,130,17946,17525,14921,421,2604,82915.32964,35.3628136,-80.0199533
410,304010113,Muddy Creek,Yadkin Pee Dee,256,328085,300012,258594,28073,41418,163576.5664,42.7077564,-70.9576038
411,304010115,Reedy Creek-Yadkin River,Yadkin Pee Dee,144,43277,40141,33749,3136,6392,92039.5854,36.060108,-81.5650931
412,304010112,Forbush Creek-Yadkin River,Yadkin Pee Dee,107,16851,15821,14792,1030,1029,68405.42588,36.060108,-81.5650931
413,304010404,Little River,Yadkin Pee Dee,123,2225,2345,2572,-120,-227,78405.4961,44.2859355,-86.2472658
414,304010206,South Yadkin River,Yadkin Pee Dee,81,10670,10348,9849,322,499,51563.81478,35.928692,-80.8093135
415,304010301,High Rock Lake-Yadkin River,Yadkin Pee Dee,182,85705,81332,76143,4373,5189,116397.5967,36.060108,-81.5650931
416,304010203,Third Creek,Yadkin Pee Dee,101,26308,24547,23292,1761,1255,64417.8652,35.7495863,-80.8561376
417,304010304,Upper Uwharrie River,Yadkin Pee Dee,223,49615,48141,45964,1474,2177,142524.5038,35.8756432,-79.9933935
418,304010402,Lake Tillery-Pee Dee River,Yadkin Pee Dee,171,16824,16134,15451,690,683,109489.8392,35.1762526,-79.9863353
419,304010302,Abbotts Creek,Yadkin Pee Dee,223,113276,107565,96646,5711,10919,142855.3776,36.04344,-80.0814275
420,304010303,High Rock Lake,Yadkin Pee Dee,207,51848,50130,46783,1718,3347,132239.8176,35.6516286,-80.3018107
421,304010306,Yadkin River,Yadkin Pee Dee,190,12035,12368,12018,-333,350,121748.254,36.060108,-81.5650931
422,304010110,Little Yadkin River-Yadkin River,Yadkin Pee Dee,213,29721,31065,28436,-1344,2629,136214.302,36.060108,-81.5650931
423,304010201,Headwaters South Yadkin River,Yadkin Pee Dee,289,26664,26717,23823,-53,2894,184928.511,35.928692,-80.8093135
424,304010401,Brown Creek,Yadkin Pee Dee,174,7957,9754,8267,-1797,1487,111351.9571,35.0020354,-80.1937753
425,304010305,Lower Uwharrie River,Yadkin Pee Dee,165,4772,4807,4542,-35,265,105733.6683,35.8756432,-79.9933935
426,304010205,Second Creek,Yadkin Pee Dee,142,26127,20640,17384,5487,3256,90575.63774,39.8772897,-104.8012028
427,304010204,Fourth Creek,Yadkin Pee Dee,89,34162,31694,28922,2468,2772,57147.28504,56.0667101,-118.9363837
428,304010109,Lower Ararat River,Yadkin Pee Dee,123,15677,16293,14888,-616,1405,78473.28059,36.4682019,-80.5437971
429,304010501,Upper Rocky River,Yadkin Pee Dee,215,268707,201233,119890,67474,81343,137897.4858,-29.3239966,152.1245993
430,304010507,Lower Rocky River,Yadkin Pee Dee,263,72738,64834,45070,7904,19764,168546.1589,35.2720286,-80.6003525
431,305010107,Lower Creek,Catawba,98,29178,30374,29916,-1196,458,62912.29704,35.9239024,-81.5097015
432,305010109,Lake Hickory-Catawba River,Catawba,142,46581,44206,40468,2375,3738,90669.02529,34.4668123,-80.8889704
433,305010102,North Fork Catawba River,Catawba,85,2687,2589,2695,98,-106,54352.09848,35.8816277,-81.9807362
434,305010106,Silver Creek-Catawba River,Catawba,233,59941,60713,58842,-772,1871,149282.6682,34.4668123,-80.8889704
435,305010201,Henry Fork,Catawba,115,27939,28163,26975,-224,1188,73302.20865,43.9185902,-111.7257202
436,304010502,Cold Water Creek,Yadkin Pee Dee,110,118548,104917,92878,13631,12039,70624.31204,35.4062286,-80.5549493
437,305010204,Upper South Fork Catawba River,Catawba,87,11366,11204,9371,162,1833,55985.76133,35.1495863,-81.0328533
438,305010104,Warrior Fork-Catawba River,Catawba,87,4997,4953,4726,44,227,55898.67982,34.4668123,-80.8889704
439,304010503,Middle Rocky River,Yadkin Pee Dee,254,120014,91317,60971,28697,30346,162788.8392,41.4768217,-81.8497567
440,305010101,Headwaters Catawba River,Catawba,181,17264,17802,16539,-538,1263,115945.8588,34.4668123,-80.8889704
441,305010103,Linville River-Lake James,Catawba,121,8089,7664,7106,425,558,77185.5262,35.7459605,-81.8364909
442,305010105,Johns River,Catawba,210,3403,3470,3756,-67,-286,134123.732,29.0756178,-81.2281919
443,305010205,Middle South Fork Catawba River,Catawba,123,30619,30925,29881,-306,1044,78594.78886,35.1495863,-81.0328533
444,304010505,Richardson Creek,Yadkin Pee Dee,234,65112,63442,53106,1670,10336,149852.7604,35.0633547,-80.3712978
445,304010504,Long Creek,Yadkin Pee Dee,201,33641,33343,32117,298,1226,128922.7664,34.4421115,-78.0097139
446,305010203,Clark Creek,Catawba,91,40223,39470,36748,753,2722,58312.80663,34.088215,-84.6418128
447,304010405,Pee Dee River-Blewett Falls Lake,Yadkin Pee Dee,166,2828,3133,3081,-305,52,106355.4425,35.0204217,-79.8940806
448,305010108,Rhodhiss Lake-Catawba River,Catawba,154,79251,80776,76356,-1525,4420,98803.70741,35.7740206,-81.431201
449,305010206,Lower South Fork Catawba River,Catawba,149,91815,82969,76052,8846,6917,95158.05751,35.1495863,-81.0328533
450,304010506,Lanes Creek,Yadkin Pee Dee,137,9139,9575,8737,-436,838,87919.32022,33.4996123,-79.3631099
451,305010202,Jacob Fork,Catawba,96,11752,12215,10460,-463,1755,61618.93398,35.6153444,-81.4935684
452,305010114,Mountain Island Lake-Catawba River,Catawba,163,197305,154481,88437,42824,66044,104173.8095,35.3511776,-80.9553294
453,305010115,Lake Wylie-Catawba River,Catawba,121,94493,81967,76758,12526,5209,77418.79503,34.4668123,-80.8889704
454,305010113,Dutchmans Creek,Catawba,141,49059,42248,34060,6811,8188,90413.61054,35.3628136,-80.0199533
455,305010110,Lookout Shoals Lake-Catawba River,Catawba,139,20460,20603,17866,-143,2737,89113.13818,35.7687839,-81.0961603
456,301010401,Hogans Creek-Dan River,Roanoke,201,16776,17588,17638,-812,-50,128336.1424,36.5274056,-79.353593
457,301020302,Sarem Creek-Chowan River,Chowan,152,5443,5669,5340,-226,329,97026.61221,36.2704217,-76.8027886
458,301010406,Hyco River,Roanoke,140,16532,16935,16498,-403,437,89543.37145,36.6837502,-78.7319498
459,301010403,Birch Creek-Dan River,Roanoke,10,451,536,531,-85,5,6355.268217,36.5049877,-79.5554428
460,601010601,Headwaters Pigeon River,French Broad,168,23109,22707,21103,402,1604,107545.7935,35.8598363,-83.1112086
461,301010402,Country Line Creek,Roanoke,138,5645,6264,6161,-619,103,88425.52137,36.3377611,-79.4675422
462,301020307,Chowan River,Chowan,117,3474,3885,3466,-411,419,74741.60101,36.2704217,-76.8027886
463,305010112,Lower Lake Norman,Catawba,137,85428,70412,47729,15016,22683,87475.3746,38.9104546,-122.6102614
464,301020304,Wiccacon River,Chowan,106,2608,3064,3212,-456,-148,68121.41892,36.3261187,-76.8302672
465,301020301,Somerton Creek,Chowan,30,1187,1388,1142,-201,246,18931.62205,36.5438245,-76.8778546
466,601010602,Richland Creek-Pigeon River,French Broad,182,34247,31472,29029,2775,2443,116323.2224,35.8598363,-83.1112086
467,305010111,Upper Lake Norman,Catawba,207,69052,63086,51556,5966,11530,132615.3576,39.1646129,-122.9105515
468,301020305,Bennetts Creek,Chowan,107,3720,4305,3713,-585,592,68245.00598,36.8377172,-76.4852254
469,301010405,Hyco Lake,Roanoke,197,7769,7821,7615,-52,206,126028.4696,36.4774842,-79.105455
470,301010407,Aarons Creek-Dan River,Roanoke,30,810,863,825,-53,38,19474.20084,36.6612505,-78.7219494
471,301020303,Ahoskie Creek,Chowan,170,12063,13777,12952,-1714,825,108583.3215,36.2856661,-77.0024664
472,601010603,Cataloochee Creek-Pigeon River,French Broad,186,1472,1574,1216,-102,358,119121.138,35.6616837,-83.0791625
473,301020306,Holiday Island-Chowan River,Chowan,120,4163,4593,4437,-430,156,76520.48136,36.2704217,-76.8027886
474,601020301,Upper Tuckasegee River,Little Tennessee,238,16584,15329,11700,1255,3629,152467.5846,35.4348151,-83.58461
475,601020202,Cullasaja River,Little Tennessee,93,6357,5605,5328,752,277,59263.39603,35.1222439,-83.298714
476,301020408,Potecasi Creek,Chowan,257,8602,12151,10706,-3549,1445,164770.1825,36.4362647,-76.9566271
477,601010801,Headwaters North Toe River,French Broad,183,18394,19182,18598,-788,584,117056.4428,35.9742848,-82.1521053
478,601020203,Nantahala River,Little Tennessee,175,1920,2070,1870,-150,200,112204.8253,35.0648016,-83.5443104
479,601020201,Headwaters Little Tennessee River,Little Tennessee,151,14505,13378,11044,1127,2334,96536.43177,35.6252879,-84.1802932
480,601020302,Oconaluftee River,Little Tennessee,188,9118,8833,8056,285,777,120236.177,35.5147347,-83.3388447
481,301010604,Lower Lake Gaston,Roanoke,121,7745,8164,7992,-419,172,77666.7512,38.9104546,-122.6102614
482,601010803,Cane River,French Broad,158,7578,7153,7294,425,-141,101012.4618,31.5155502,-92.7230514
483,601020204,Alarka Creek-Little Tennessee River,Little Tennessee,204,16695,15447,13744,1248,1703,130311.98,35.6252879,-84.1802932
484,301010602,Upper Lake Gaston,Roanoke,55,2978,3452,3849,-474,-397,35442.58848,39.1646129,-122.9105515
485,301020409,Tarrara Creek-Meherrin River,Chowan,192,8626,9747,9566,-1121,181,122626.9076,35.7595731,-79.0192997
486,601010806,North Indian Creek-Nolichucky River,French Broad,27,257,253,312,4,-59,17445.54195,36.1295749,-82.7761868
487,301010603,Middle Lake Gaston,Roanoke,78,2317,2233,1981,84,252,49666.44417,36.5076208,-77.9453091
488,601020303,Middle Tuckasegee River,Little Tennessee,163,20340,19371,16739,969,2632,104488.606,35.4348151,-83.58461
489,601020304,Lower Tuckasegee River,Little Tennessee,144,5548,5631,5244,-83,387,92410.72943,35.4348151,-83.58461
490,601020205,Fontana Lake,Little Tennessee,167,1358,1425,1179,-67,246,106973.3971,35.4441394,-83.727883
491,601010302,Elk River,Watauga,52,5172,5133,4820,39,313,33343.47142,45.303218,-93.5547381
492,601010802,South Toe River-North Toe River,French Broad,259,15257,15353,15307,-96,46,165938.4866,35.8269315,-82.2148465
493,301020407,Fountains Creek,Chowan,48,2155,2554,2477,-399,77,30400.12987,40.5163233,-87.8093586
494,601010512,Spring Creek-French Broad River,French Broad,106,1959,2113,2328,-154,-215,67887.97692,35.5627536,-82.8631741
495,304020104,Thompson Creek,Yadkin Pee Dee,53,666,771,702,-105,69,33681.18876,38.948337,-76.837841
496,601010507,Cane Creek-French Broad River,French Broad,154,75931,63723,49266,12208,14457,98446.74067,35.5627536,-82.8631741
497,601010506,Swannanoa River,French Broad,133,61770,57504,51473,4266,6031,84979.23296,35.5896798,-82.4412766
498,601010303,Watauga Lake-Watauga River,Watauga,152,16605,16092,13540,513,2552,97154.10042,36.3553019,-82.222941
499,601010509,Sandymush Creek-French Broad River,French Broad,236,98314,87959,77966,10355,9993,150922.0669,35.6902283,-82.7712806
500,304020103,Marks Creek-Pee Dee River,Yadkin Pee Dee,168,11143,12828,13178,-1685,-350,107596.1188,34.8844123,-79.6726632
501,601010508,Ivy Creek,French Broad,161,16331,15482,14060,849,1422,103091.1798,34.0970578,-83.9365556
502,601010501,Headwaters French Broad River,French Broad,130,7344,7606,6926,-262,680,83119.54114,35.5627536,-82.8631741
503,304020201,Headwaters Lynches River,Yadkin Pee Dee,26,1892,1791,1712,101,79,16781.68499,34.3313506,-79.9898651
504,304020102,Jones Creek,Yadkin Pee Dee,100,8243,9906,9959,-1663,-53,63744.37111,28.9685817,-95.4552208
505,601010511,Walnut Creek-French Broad River,French Broad,95,4706,4852,4621,-146,231,60945.35626,37.9100783,-122.0651819
506,601010504,Mills River-French Broad River,French Broad,133,24084,22645,19764,1439,2881,84913.49216,35.4064582,-82.6267345
507,304020312,Headwaters Ashpole Swamp,Lumber,202,12768,15767,16083,-2999,-316,129435.5348,34.5259966,-79.2328172
508,304020101,Hitchcock Creek,Yadkin Pee Dee,143,27926,29728,28984,-1802,744,91223.69838,34.9619382,-79.7547071
509,601010505,Hominy Creek,French Broad,104,45532,39834,33185,5698,6649,66510.29323,35.5582244,-82.5960766
510,601010304,Doe River,Watauga,1,99,157,62,-58,95,573.6260263,36.2449897,-82.1386825
511,601010502,Davidson River-French Broad River,French Broad,168,24033,23890,21160,143,2730,107249.3209,35.2534477,-82.6840127
512,304020105,Reedys Branch-Great Pee Dee River,Yadkin Pee Dee,22,976,1079,1110,-103,-31,13788.08349,34.1715296,-79.536862
513,601010503,Mud Creek,French Broad,113,64351,58645,51087,5706,7558,72119.45262,36.0270814,-80.3436639
514,601010510,Big Laurel Creek,French Broad,132,3024,2792,2927,232,-135,84691.89449,35.915235,-82.6427863
515,304020308,Middle Big Swamp,Lumber,85,6769,7661,6509,-892,1152,54718.30673,34.7790474,-78.7360505
516,304020310,Saddletree Swamp-Lumber River,Lumber,115,31760,36797,34484,-5037,2313,73690.29926,34.6807193,-79.0244763
517,304020303,Gum Swamp-Lumber River,Lumber,94,9375,8717,7984,658,733,60192.09503,34.5669774,-79.1432093
518,304020603,Headwaters Waccamaw River,Lumber,203,5610,6583,6800,-973,-217,129815.281,33.6959905,-78.9224708
519,304020305,Raft Swamp,Lumber,169,23992,26589,23267,-2597,3322,107998.3759,34.6483012,-79.098396
520,304020304,Bear Swamp-Lumber River,Lumber,85,18402,20429,16992,-2027,3437,54112.90064,34.5669774,-79.1432093
521,304020402,Leith Creek,Lumber,73,14763,16015,16361,-1252,-346,46420.13853,34.8016904,-79.4591268
522,304020606,Gore Creek-Waccamaw River,Lumber,113,3177,3678,3308,-501,370,72568.50629,33.6959905,-78.9224708
523,304020405,Middle Little Pee Dee River,Lumber,18,1207,1412,1565,-205,-153,11445.16911,34.1648056,-79.3351153
524,304020604,Juniper Creek-Waccamaw River,Lumber,167,600,710,636,-110,74,107181.6167,33.6959905,-78.9224708
525,304020602,White Marsh,Lumber,134,15324,17699,16953,-2375,746,85751.11457,39.3794196,-76.4599043
526,304020302,Lower Drowning Creek,Lumber,194,37269,32591,26713,4678,5878,124156.1477,36.4733765,-94.8671617
527,304020403,Shoe Heel Creek,Lumber,156,8225,9957,9759,-1732,198,99936.18972,34.6504772,-79.3690824
528,304020406,Lake Swamp-Little Pee Dee River,Lumber,8,2154,2439,976,-285,1463,5345.517193,34.1648056,-79.3351153
529,304020601,Red Hill Swamp,Lumber,172,6333,7422,7416,-1089,6,110092.5296,34.4376696,-78.6819602
530,304020401,Upper Little Pee Dee River,Lumber,138,13130,14666,14812,-1536,-146,88453.13147,34.1648056,-79.3351153
531,304020313,Ashpole Swamp,Lumber,19,776,994,1039,-218,-45,11870.69749,34.5259966,-79.2328172
532,304020309,Lower Big Swamp,Lumber,90,5488,6230,6045,-742,185,57827.65544,34.7790474,-78.7360505
533,304020301,Upper Drowning Creek,Lumber,130,6474,7097,5688,-623,1409,83079.12851,36.4733765,-94.8671617
534,304020307,Upper Big Swamp,Lumber,116,6564,7096,6168,-532,928,74321.66822,35.7595731,-79.0192997
535,304020314,Outlet Lumber River,Lumber,46,1253,1723,1815,-470,-92,29428.92819,34.5669774,-79.1432093
536,304020306,Gallberry Swamp,Lumber,152,19748,20818,17664,-1070,3154,97448.05969,34.8210849,-78.8976988
537,304020311,Porter Swamp-Lumber River,Lumber,134,5360,6505,7102,-1145,-597,85728.98118,34.3402526,-78.9497906
538,305010509,Kings Creek,Broad,17,2603,2455,2701,148,-246,10759.70864,37.2663696,-76.6343594
539,305010512,North Pacolet River,Broad,68,9055,9342,8941,-287,401,43588.24297,35.1109524,-81.9634396
540,304020802,Shallotte River,Lumber,85,22874,20602,15418,2272,5184,54165.27012,33.9057282,-78.3786145
541,305010303,Cane Creek,Catawba,23,2552,2617,1970,-65,647,14559.60813,35.7595731,-79.0192997
542,305010508,Buffalo Creek,Broad,161,40059,39339,37900,720,1439,103248.3307,39.3869295,-105.2708903
543,305010502,Lower Green River,Broad,108,7787,8664,7365,-877,1299,69256.15751,35.181306,-82.5334443
544,305010505,Sandy Run-Broad River,Broad,177,26976,28014,25657,-1038,2357,113219.8584,35.7595731,-79.0192997
545,305010503,Headwaters Broad River,Broad,280,21755,21832,19525,-77,2307,179302.0188,35.7595731,-79.0192997
546,305010504,Second Broad River,Broad,221,29417,31314,28659,-1897,2655,141615.5475,35.3791792,-81.8660624
547,305010302,Twelvemile Creek,Catawba,118,147304,110808,42758,36496,68050,75626.10033,-32.6525657,151.8661805
548,304020607,Buck Creek-Waccamaw River,Lumber,96,13657,10832,6850,2825,3982,61256.97434,33.6959905,-78.9224708
549,305010515,Pacolet River,Broad,5,391,431,337,-40,94,3072.619519,34.8854867,-81.5978887
550,305010901,North Saluda River,Broad,0,5,5,2,0,3,110.7059808,35.047044,-82.4698346
551,305010507,Lower First Broad River,Broad,144,42904,41937,42851,967,-914,92048.00755,35.2076278,-81.6062443
552,304020801,Lockwoods Folly River,Lumber,147,18242,14866,11891,3376,2975,94121.08882,33.9214355,-78.2475396
553,304020803,Little River,Lumber,21,8403,6810,5179,1593,1631,13559.53398,44.2859355,-86.2472658
554,304020605,Seven Creeks,Lumber,168,11759,13180,12057,-1421,1123,107280.3945,-36.4355718,145.391801
555,305010506,Upper First Broad River,Broad,181,7697,8032,7705,-335,327,115629.4328,35.2076278,-81.6062443
556,305010306,Fishing Creek Reservoir-Catawba River,Catawba,35,5413,5029,3934,384,1095,22648.88792,34.4668123,-80.8889704
557,305010301,Sugar Creek,Catawba,230,638079,551417,485876,86662,65541,147067.9375,40.50312,-81.6409582
558,305010511,Bullock Creek,Broad,3,251,257,287,-6,-30,1604.420604,34.8543012,-81.4117577
559,305010516,Cherokee Creek-Broad River,Broad,12,1904,1861,1663,43,198,7969.961512,35.7595731,-79.0192997
560,305010902,South Saluda River,Broad,0,10,9,4,1,5,284.9493154,35.0544221,-82.7266173
561,306010202,Chattooga River,Savannah,62,1882,1679,1451,203,228,39831.472,34.9265591,-83.2076373
562,301010707,Headwaters Cashie River,Roanoke,125,3493,4381,4461,-888,-80,79720.43086,36.0713391,-77.0506291
563,301010702,Conoconnara Swamp-Roanoke River,Roanoke,169,3371,4234,4418,-863,-184,108206.5539,36.213967,-77.579494
564,302020203,Mosley Creek-Neuse River,Neuse,194,28731,31679,33134,-2948,-1455,123965.945,35.7595731,-79.0192997
565,301010703,Kehukee Swamp-Roanoke River,Roanoke,152,2171,2791,3303,-620,-512,97122.58524,36.1059893,-77.4144138
566,301010704,Sweetwater Creek,Roanoke,116,6385,6754,6752,-369,2,74198.78096,33.7713138,-84.7724336
567,302020206,Hog Island-Neuse River,Neuse,232,12683,13168,11550,-485,1618,148712.1056,35.1312747,-76.5038153
568,302020201,Walnut Creek-Neuse River,Neuse,116,38257,38804,39829,-547,-1025,74041.15115,37.9100783,-122.0651819
569,306010201,Tallulah River,Savannah,11,118,14,96,104,-82,6765.439265,34.7162056,-83.3523856
570,302020205,Swift Creek,Neuse,159,7760,7960,6760,-200,1200,101916.1888,-37.2631851,147.7216178
571,302020202,Bear Creek-Neuse River,Neuse,187,28788,30969,29775,-2181,1194,119884.8453,35.1312747,-76.5038153
572,301010701,Quankey Creek-Roanoke River,Roanoke,131,29848,32626,33422,-2778,-796,83593.47202,36.1442401,-77.1588948
573,301010708,Outlet Cashie River,Roanoke,194,6776,7584,6198,-808,1386,124272.3316,36.0713391,-77.0506291
574,301010705,Conoho Creek-Roanoke River,Roanoke,213,7849,9311,10253,-1462,-942,136364.2447,35.9747077,-77.2752692
575,301010706,Gardener Creek-Roanoke River,Roanoke,113,2678,2959,2996,-281,-37,72620.16997,36.1442401,-77.1588948
576,302020204,Clayroot Swamp-Swift Creek,Neuse,177,54861,48567,32989,6294,15578,113218.1195,35.4271442,-77.2448186
577,301010709,Plymouth-Roanoke River,Roanoke,97,6663,7927,8157,-1264,-230,62102.303,35.8668281,-76.7485555
578,301020205,Kingsale Swamp-Blackwater River,Chowan,0,0,0,0,0,0,94.26162144,35.7595731,-79.0192997
579,305010501,Upper Green River,Broad,137,11580,11289,9136,291,2153,87397.86266,35.181306,-82.5334443
580,602000209,Spring Creek-Hiwassee River,Hiwassee,81,1409,1367,1335,42,32,51572.06248,35.4100705,-85.0102305
581,301020510,North River,Pasquotank,166,4417,4000,3247,417,753,106157.9627,43.1539855,-123.3787881
582,602000204,Valley River,Hiwassee,117,9386,9714,9210,-328,504,74947.93314,44.0704092,-123.1048665
583,306010102,Keowee River-Lake Keowee,Savannah,2,66,60,39,6,21,1069.565521,34.7641984,-82.8802099
584,301020508,Gum Neck-Alligator River,Pasquotank,325,330,385,347,-55,38,207752.9652,35.7587445,-76.1319953
585,301020507,Pasquotank River,Pasquotank,344,43699,43402,36103,297,7299,219968.6492,36.304911,-76.2187525
586,602000202,Tusquitee Creek-Hiwassee River,Hiwassee,109,6030,5673,4858,357,815,70048.88227,35.0845348,-83.7657282
587,301020505,Little River,Pasquotank,134,8222,8365,6583,-143,1782,85985.31951,44.2859355,-86.2472658
588,301020502,Bull Bay-Scuppernong River,Pasquotank,272,4601,5787,5644,-1186,143,173783.8506,35.8926346,-76.3318457
589,306010101,Headwaters Keowee River-Lake Jocassee,Savannah,97,3424,2979,2562,445,417,61981.57971,34.7641984,-82.8802099
590,301020514,Albemarle Sound-Croatan Sound,Pasquotank,407,26523,24121,21380,2402,2741,260191.5663,35.8466239,-75.7022567
591,301020516,Hatteras Island,Pasquotank,2,8,5,21,3,-16,1332.099062,35.24804,-75.5393155
592,602000203,Brasstown Creek-Hiwassee River,Hiwassee,58,5584,5423,4455,161,968,37355.59031,35.4100705,-85.0102305
593,602000201,Hiwassee River-Chatuge Lake,Hiwassee,58,3097,2964,2439,133,525,37082.64169,35.7595731,-79.0192997
594,602000207,Hiwassee Lake-Hiwassee River,Hiwassee,157,7287,6810,5777,477,1033,100369.7027,35.1642457,-84.254086
595,301020501,Edenton Bay-Albemarle Sound,Pasquotank,241,10450,11668,12118,-1218,-450,154332.5229,36.0524363,-76.5982818
596,602000206,Nottely River,Hiwassee,46,5681,4937,3843,744,1094,29563.35147,35.0898051,-84.0763001
597,301020503,Perquimmans River,Pasquotank,219,7876,8442,7728,-566,714,140467.9146,36.2061136,-76.4099532
598,301020509,Alligator River,Pasquotank,262,507,985,902,-478,83,167634.4874,35.9671031,-75.9815827
599,301020504,Yeopim River-Albemarle Sound,Pasquotank,182,3797,3719,2943,78,776,116450.5862,36.0743272,-76.4066044
600,602000302,Ocoee River,Hiwassee,18,1053,925,751,128,174,11542.47093,35.1468035,-84.6714423
601,301020112,Mill Creek-Nottoway River,Chowan,1,9,12,12,-3,0,737.0779931,35.7595731,-79.0192997
602,301020515,Croatan Sound,Pasquotank,398,2473,2271,2090,202,181,254631.4246,35.8466239,-75.7022567
603,302010205,Middle Fishing Creek,Tar-Pamlico,122,3298,3960,4264,-662,-304,78348.54631,36.2563508,-78.5887951
604,302010107,Sandy Creek,Tar-Pamlico,161,18551,20294,20385,-1743,-91,103052.8988,43.6442352,-76.0860345
605,302010303,Conetoe Creek,Tar-Pamlico,99,3431,3923,4043,-492,-120,63460.24025,35.7533049,-77.4917961
606,302010203,Upper Fishing Creek,Tar-Pamlico,173,8991,10528,9760,-1537,768,110631.012,38.322345,-76.2243879
607,302010104,Crooked Creek-Tar River,Tar-Pamlico,136,27529,22228,16261,5301,5967,86870.7565,35.7567658,-77.4351508
608,302010301,Town Creek,Tar-Pamlico,198,24444,26960,25356,-2516,1604,126698.4928,34.6812011,-87.4061342
609,302010204,Beech Swamp,Tar-Pamlico,178,5175,6509,6807,-1334,-298,113855.4146,36.1208639,-77.5361462
610,302010102,Tabbs Creek-Tar River,Tar-Pamlico,170,31088,29986,26415,1102,3571,108713.5415,36.316002,-78.570854
611,301020512,North Landing River,Pasquotank,41,2781,2878,2042,-97,836,26543.58155,36.6904783,-76.0855931
612,302010106,Tar River Reservoir-Tar River,Tar-Pamlico,200,37520,36649,31250,871,5399,128162.2717,35.8978674,-77.8860316
613,302010302,Otter Creek-Tar River,Tar-Pamlico,125,15661,17677,15711,-2016,1966,80062.64864,35.7567658,-77.4351508
614,301020517,Sand Ridge-Bodie Island,Pasquotank,3,170,134,185,36,-51,1658.338726,35.8943395,-75.5896151
615,302010201,Shocco Creek,Tar-Pamlico,84,3123,3529,3321,-406,208,53803.40582,36.2687595,-78.170616
616,301020506,Dismal Swamp Canal-Lake Drummond,Pasquotank,47,1154,1417,988,-263,429,30321.8525,35.7595731,-79.0192997
617,301020513,Currituck Sound,Pasquotank,216,14174,12290,10397,1884,1893,138421.7111,36.3801838,-75.8882508
618,302010109,Beech Branch-Tar River,Tar-Pamlico,105,33395,37108,39348,-3713,-2240,67124.69218,35.7567658,-77.4351508
619,302010202,Little Fishing Creek,Tar-Pamlico,188,6354,7203,7344,-849,-141,120051.6088,33.093811,-83.284027
620,302010108,Swift Creek,Tar-Pamlico,111,5518,6067,5762,-549,305,71058.44741,-37.2631851,147.7216178
621,302010103,Lynch Creek-Tar River,Tar-Pamlico,138,14951,15847,14261,-896,1586,88287.46568,35.7567658,-77.4351508
622,302010101,Aycock Creek-Tar River,Tar-Pamlico,166,8907,9402,8400,-495,1002,106527.2823,35.7567658,-77.4351508
623,301020511,Northwest River,Pasquotank,108,12194,9255,6367,2939,2888,69003.89227,36.5618753,-76.2101812
624,302010105,Stony Creek,Tar-Pamlico,118,21399,21206,18945,193,2261,75291.09773,41.2645413,-72.746208
625,302010206,Lower Fishing Creek,Tar-Pamlico,149,3998,4856,5246,-858,-390,95498.94221,38.322345,-76.2243879
626,302020107,Milburnie Lake-Neuse River,Neuse,112,197402,149611,78033,47791,71578,71677.11869,35.1312747,-76.5038153
627,302010402,South Creek-Pamlico River,Tar-Pamlico,279,5188,5739,5873,-551,-134,178739.0849,35.3182214,-76.4327016
628,302010407,Pamlico River,Tar-Pamlico,102,329,472,522,-143,-50,64995.77958,35.3182214,-76.4327016
629,302020105,Middle Falls Lake,Neuse,139,52396,40536,28077,11860,12459,88966.91032,43.1006314,-73.5248367
630,302010305,Tranters Creek,Tar-Pamlico,243,13726,14807,13728,-1081,1079,155562.3711,35.5656515,-77.1030931
631,302010403,Pantego Creek,Tar-Pamlico,173,3471,3982,4252,-511,-270,110983.8377,35.5402327,-76.6427101
632,302010504,Cape Lookout Shoals-Core Banks,Tar-Pamlico,96,1103,1509,1562,-406,-53,61255.01657,34.5739481,-76.5248555
633,302010502,Pamlico Sound-Ocracoke Inlet,Tar-Pamlico,613,800,948,771,-148,177,392048.3846,35.0861054,-76.0333885
634,302010501,Lake Mattamuskeet-Rose Bay,Tar-Pamlico,357,2086,2753,2894,-667,-141,228657.84,35.5201372,-76.1088001
635,302010406,Outlet Pungo River,Tar-Pamlico,146,2615,3118,2894,-503,224,93365.57753,35.5061703,-76.560295
636,302010405,Intracoastal Waterway-Pungo River,Tar-Pamlico,230,1054,1156,1201,-102,-45,147483.7344,35.5061703,-76.560295
637,302010503,Pamlico Sound-Hatteras Inlet,Tar-Pamlico,617,4191,4493,4205,-302,288,394951.7805,35.1909311,-75.7574989
638,302020102,Little River,Neuse,105,15651,14698,13663,953,1035,67119.45273,44.2859355,-86.2472658
639,302020101,Flat River,Neuse,175,19908,19729,16510,179,3219,111910.1422,43.2289544,-85.2204062
640,302020106,Lower Falls Lake,Neuse,98,51927,45162,33916,6765,11246,62924.54287,45.2623403,-61.0566425
641,302020104,Upper Falls Lake,Neuse,100,73323,66674,63076,6649,3598,63714.33892,48.4564972,-121.4000132
642,302010304,City of Greenville-Tar River,Tar-Pamlico,101,56710,57256,50116,-546,7140,64367.04804,35.612661,-77.3663538
643,302020109,Middle Creek,Neuse,132,124054,93410,50808,30644,42602,84361.03992,33.3296012,-86.9975662
644,302010401,Chocowinity Bay-Pamlico River,Tar-Pamlico,237,24526,25309,23907,-783,1402,151838.6409,35.497862,-77.030539
645,302020103,Eno River,Neuse,155,75970,66180,53591,9790,12589,99111.47035,36.0876172,-78.996519
646,302010306,Tar River,Tar-Pamlico,194,40085,42573,32690,-2488,9883,124410.876,35.7567658,-77.4351508
647,302010404,Headwaters Pungo River,Tar-Pamlico,139,888,1105,1098,-217,7,88863.57976,35.5061703,-76.560295
648,302020108,Crabtree Creek,Neuse,145,337990,285621,223740,52369,61881,92973.03717,35.8107098,-78.6794572
649,302020110,Swift Creek,Neuse,156,158668,133002,105681,25666,27321,99541.31504,-37.2631851,147.7216178
650,302020304,Wiggins Mill Reservoir-Contentnea Creek,Neuse,128,42025,42608,38447,-583,4161,82119.52453,35.6890109,-77.9479762
651,302020113,Mill Creek,Neuse,190,18279,17148,15181,1131,1967,121316.2818,34.0780572,-83.8781908
652,302020401,Upper Trent River,Neuse,175,5648,5598,5374,50,224,111734.2967,35.0532419,-77.389313
653,302020404,Upper Broad Creek-Neuse River,Neuse,96,25756,27277,24273,-1521,3004,61375.51728,35.1312747,-76.5038153
654,302020114,Falling Creek,Neuse,118,11000,12119,11137,-1119,982,75284.73122,35.2621075,-77.6905291
655,302020111,Walnut Creek-Neuse River,Neuse,192,218571,181250,135148,37321,46102,122706.5352,37.9100783,-122.0651819
656,302020406,Town of Oriental-Neuse River,Neuse,165,6548,6695,6208,-147,487,105795.6743,35.1312747,-76.5038153
657,302020117,Moccasin Creek-Neuse River,Neuse,174,35362,35950,32634,-588,3316,111498.0912,35.1312747,-76.5038153
658,302020407,Neuse River,Neuse,182,1089,1049,934,40,115,116186.1988,35.1312747,-76.5038153
659,302020302,Black Creek,Neuse,102,10003,10743,9629,-740,1114,65262.93801,44.4774856,-88.4506568
660,302020115,Upper Little River,Neuse,190,48142,40302,31204,7840,9098,121403.412,34.8002309,-78.4824501
661,302020305,Nahunta Swamp,Neuse,99,12803,12807,9736,-4,3071,63059.23586,35.4957624,-77.9194236
662,302020403,Lower Trent River,Neuse,167,30894,27829,21735,3065,6094,106627.6122,35.0532419,-77.389313
663,302020405,Cherry Point-Neuse River,Neuse,180,25908,29661,29429,-3753,232,115261.1719,35.1312747,-76.5038153
664,302020307,Contentnea Creek,Neuse,213,20481,21265,18040,-784,3225,136425.0281,35.5195485,-77.6704405
665,302020301,Buckhorn Reservoir,Neuse,158,26217,22591,18694,3626,3897,101403.1328,35.7117429,-78.1535928
666,302020306,Little Contentnea Creek,Neuse,182,16808,18030,17092,-1222,938,116484.304,35.4268294,-77.4782995
667,302020112,Black Creek,Neuse,102,32732,24435,15859,8297,8576,65028.04303,44.4774856,-88.4506568
668,302020303,Toisnot Swamp,Neuse,126,26273,27123,24593,-850,2530,80730.6462,35.7219731,-77.9623078
669,302020402,Middle Trent River,Neuse,200,4949,5306,5415,-357,-109,128040.6048,35.0532419,-77.389313
670,302020408,Jones Bay-Bay River,Neuse,192,4648,5347,5466,-699,-119,122933.3528,35.2175708,-76.5199195
671,302020116,Lower Little River,Neuse,126,27059,26379,23248,680,3131,80397.33332,33.2114773,-83.3886668
672,303000205,Cane Creek-Haw River,Cape Fear,270,37502,31354,25727,6148,5627,173021.9883,35.6255669,-79.0588553
673,302030202,New River,White Oak,255,78920,75413,71046,3507,4367,163099.7454,37.3494322,-80.930663
674,301010209,Butcher Creek-John H Kerr Reservoir,Roanoke,67,2874,3138,2795,-264,343,42851.00189,36.5674164,-78.4749412
675,302030102,Outlet White Oak River,White Oak,131,11636,9768,7028,1868,2740,83834.53289,34.8814492,-77.2201721
676,303000207,Roberson Creek-Haw River,Cape Fear,137,22714,14921,11627,7793,3294,87960.25699,35.6255669,-79.0588553
677,303000203,Big Alamance Creek,Cape Fear,262,114696,98396,78740,16300,19656,167835.6933,36.0283516,-79.4309761
678,302030201,Headwaters New River,White Oak,161,72726,62515,48857,10211,13658,103099.3466,34.7540836,-77.4693666
679,302030101,Headwaters White Oak River,White Oak,142,3649,4034,3536,-385,498,91156.54173,34.8814492,-77.2201721
680,301010210,Nutbush Creek-John H Kerr Reservoir,Roanoke,114,13650,14363,13589,-713,774,72665.00886,36.3603731,-78.409816
681,302020409,Neuse River-Pamlico Sound,Neuse,227,150,178,174,-28,4,145270.3115,35.1312747,-76.5038153
682,302030103,Bogue Banks-Bogue Sound,White Oak,105,29100,24947,20097,4153,4850,67120.89551,34.6946061,-76.8146587
683,302030106,Oyster Creek-Jarrett Bay,White Oak,84,1474,1864,1820,-390,44,53458.00544,35.1182265,-75.9754538
684,303000206,B Everett Jordan Lake-New Hope River,Cape Fear,343,378573,294198,221726,84375,72472,219557.4019,35.6576505,-79.0705702
685,303000201,Reedy Fork,Cape Fear,255,316375,289406,255353,26969,34053,163353.6372,36.1848253,-79.6965359
686,302030107,Bogue Banks-Shackleford Banks,White Oak,78,14242,14493,14971,-251,-478,50218.62781,34.6808138,-76.632607
687,302030205,Masonboro Inlet-Mason Inlet,White Oak,64,85075,75335,60522,9740,14813,40684.49509,34.1825403,-77.7995573
688,302030204,Topsail Beach,White Oak,64,29056,21123,13264,7933,7859,40693.99851,34.3651685,-77.6305293
689,303000202,Headwaters Haw River,Cape Fear,189,41475,38312,31506,3163,6806,120730.683,36.094939,-79.3569372
690,303000204,Back Creek-Haw River,Cape Fear,251,88399,78736,69725,9663,9011,160394.8528,36.094939,-79.3569372
691,302030203,New River Inlet,White Oak,81,20810,12119,8940,8691,3179,51976.96594,34.5290127,-77.3360319
692,302030104,Newport River,White Oak,149,27946,28089,24122,-143,3967,95158.66605,34.7719043,-76.8446894
693,301010208,Grassy Creek-John H Kerr Reservoir,Roanoke,118,4569,4944,4418,-375,526,75293.78578,36.5674164,-78.4749412
694,302030105,North River,White Oak,68,6543,6528,5936,15,592,43838.06912,43.1539855,-123.3787881
695,505000102,South Fork New River,New,328,51095,48193,40810,2902,7383,210142.8158,36.3699301,-81.5045461
696,301010309,Cascade Creek-Dan River,Roanoke,131,18938,19598,19913,-660,-315,83789.07218,36.5049877,-79.5554428
697,301010302,Town Fork Creek,Roanoke,135,20916,21938,21282,-1022,656,86510.29168,39.0295599,-94.5469705
698,301010301,Little Dan River-Dan River,Roanoke,164,7312,7846,7648,-534,198,105101.9811,36.6121538,-80.3904796
699,301010305,Matrimony Creek-Dan River,Roanoke,178,25131,25557,25526,-426,31,114048.9612,36.5049877,-79.5554428
700,601020401,Cheoah River,Little Tennessee,215,6584,7333,6666,-749,667,137707.4495,35.4481407,-83.9396253
701,505000103,Fox Creek-New River,New,23,737,680,632,57,48,14586.57034,34.7540836,-77.4693666
702,505000104,Little River-New River,New,152,8782,9187,8755,-405,432,97225.43479,34.7540836,-77.4693666
703,301010304,Mayo River,Roanoke,74,7364,7887,7805,-523,82,47234.0302,36.4614396,-79.9640274
704,505000101,North Fork New River,New,249,11342,12290,11408,-948,882,159397.8349,36.4434323,-81.5264968
705,301010303,Belews Lake-Dan River,Roanoke,222,34544,34418,32036,126,2382,141805.6725,36.308756,-80.0339312
706,505000106,Chestnut Creek-New River,New,2,99,93,106,6,-13,1366.477263,34.7573853,-77.409685
707,601020403,Tellico River,Little Tennessee,11,22,12,157,10,-145,6917.204649,35.6036896,-84.2126931
708,301010308,Lower Smith River,Roanoke,11,7222,7663,7469,-441,194,6780.452559,43.7762572,-123.9101717
709,601020404,Upper Tellico Lake,Little Tennessee,48,58,72,120,-14,-48,30980.9398,35.7595731,-79.0192997
